v	v	v	v	v	v
v	i	s	s	l	v
v	i	s	l	i	v
v	i	s	s	i	v
v	v	v	v	v	v